0  4  4  4  4  4  4  4  4  4  4  4  4  4  4  4  4  4  4  4  4  4  4  0  
4  0  0  0  0  0  0  0  0  0  0  0  0  0  0  0  0  0  0  0  0  0  0  4  
4  0  0  1  1  1  1  1  0  0  2  2  2  2  0  0  1  1  1  1  1  0  0  4  
4  0  0  5  0  0 -5  1  2  0  0  2  2  0  0  2  1 -5  0  0  5  0  0  4  
4  0  0  1  1  0  0  1  1  1  1  2  2  1  1  1  1  0  0  1  1  0  0  4  
4  0  0  0  1  0  0  0  1  0  0  5  5  0  0  0  0  0  0  1  0  0  0  4  
4  0  0  0  1  0  0  0  0  0  0  2  2  0  0  0  0  0  0  1  0  0  0  4  
4  0  0  0  1  0  0  0  0  6  0  5  5  0  7  0  0  0  0  1  0  0  0  4  
4  0  0  0  1  1  0  0  0  0  0  2  2  0  0  0  0  0  1  1  0  0  0  4  
4  0  0  0  0  1  1  1  1  0  0  2  2  0  0  1  1  1  1  0  0  0  0  4  
4  0  0  0  0  0  0  0  1  1  0  2  2  0  1  1  0  0  0  0  0  0  0  4  
4  0  0  0  0  0  0  0  0  1  0  0  0  0  1  0  0  0  0  0  0  0  0  4  
4  0  0  0  0  0  0  0  0  0  1  1  1  1  0  0  0  0  0  0  0  0  0  4  
0  4  4  4  4  4  4  4  4  4  4  4  4  4  4  4  4  4  4  4  4  4  4  0  

