0  0  0  0  0  0  2  2  2  2  2  2  2  2  2  2  2  2  0  0  0  0  0  0  
0  0  0  0  0  0  2  0  0  0  0  2  0  0  0  0  0  2  0  0  0  0  0  0  
0  2  2  2  2  0  2  0  2  2  0  2  0  0  0  0  0  2  0  0  0  0  0  0  
0  2  6  0  2  2  2  0  2  2  0  0  0  0  0  0  0  2  2  2  2  2  2  2  
0  2  0  0  2  0  0  0  2  2  2  2  0  0  2  2  0  0  0  0  0  0  0  2  
0  2  0  0  2  0  0  0  0  0  2  2  2  0  2  2  0  0  2  2  2  2  0  7  
2  2  0  0  2  0  0  0  0  0  0  3  5  0  0  0  0  0  2  0  0  2  2  2  
2  0  0 -5  2  0  0  0 -5  0  0  3  5 -5  0  0  0  0  2  0  0  0  0  0  
2  0  2  2  2  2  2  0  0  0  0  3  0  2  2  2  2  2  2  0  0  0  0  0  
2  0  0  0  0  0  0  2  2  0  2  2  0  0  0  0  0  0  0  0  0  0  0  0
2  0  0  0  0  2  0  2  2  0  2  0  0  0  0  0  0  0  0  0  0  0  0  0  
2  2  2  2  0  2  0  2  2  0  2  0  0  0  0  0  0  0  0  0  0  0  0  0  
0  0  0  2  0  0  0  0  0  0  2  0  0  0  0  0  0  0  0  0  0  0  0  0  
0  0  0  2  2  2  2  2  2  2  2  0  0  0  0  0  0  0  0  0  0  0  0  0  

