0 0 4 4 3 3 3 3 3 4 4 0 0 0 0 0 0 0 0 0 0 0 0 0 
0 0 4 0 0 0 0 0 0 0 4 0 0 0 0 0 0 0 0 0 0 0 0 0 
0 4 4 0 4 1 1 1 4 0 4 4 4 4 4 0 0 0 0 0 0 0 0 0 
0 4 0 0 4 0 0 0 4 0 0 0 0 0 4 0 0 0 0 0 0 0 0 0 
0 4 0 4 4 0 0 0 4 0 0 8 8 0 4 0 0 0 0 0 0 0 0 0 
0 4 0 0 4 4 4 0 4 4 0 0 0 0 4 0 4 4 4 4 4 4 4 0 
4 4 4 0 0 0 1 0 0 5 0 0 0 0 4 4 4 0 0 0 0 7 4 4 
1 7 0 0 0 0 1 0 0 5 0 0 0 0 0 0 0 0 0 0 8 0 0 4 
1 0 0 3 0 0 1 0 0 5 5 4 4 4 4 4 0 0 0 0 8 0 0 4 
1 0 0 3 0 0 1 0 0 0 0 0 0 0 0 5 0 0 0 0 0 0 0 4 
1 0 0 0 0 0 1 0 0 0 0 0 0 0 0 4 4 4 4 1 0 0 7 4 
4 4 8 0 8 4 4 0 0 0 0 0 0 0 0 0 0 0 0 1 0 1 1 0 
0 0 8 0 8 0 0 0 0 0 0 0 0 0 0 0 0 0 0 1 0 1 0 0 
0 0 8 2 8 0 0 0 0 0 0 0 0 0 0 0 0 0 0 1 6 1 0 0 

