0  0  4  4  3  3  3  3  3  4  4  0  0  0  0  0  0  0  0  0  0  0  0  0  
0  0  4  0  0  0  0  0  0  0  4  0  0  0  0  0  0  0  0  0  0  0  0  0  
0  4  4  0  4  1  1  1  4  0  4  4  4  4  4  0  0  0  0  0  0  0  0  0  
0  4  0  0  4  0  0  0  4  0  0  0  0  0  4  0  0  0  0  0  0  0  0  0  
0  4  0  4  4  0  0  0  4  0  0  2  2  0  4  0  0  0  0  0  0  0  0  0  
0  4  0  0  4  4  4  0  4  4  0  0  0  0  4  0  4  4  4  4  4  4  4  0  
4  4  4  0  0  0  1  0  0  5  0  0  0 -1  4  4  4  0  0  0  0  0  4  4  
1  0  0 -1  0  0  1  0  0  5  0  0  0  0  0  0  0  0  0  0  2  0  0  4  
1 -5  0  3  0  0  1  0  0  5  5  4  4  4  4  4  0  0  0 -5  2  0 -5  4  
1  0  0  3  0  0  1  0  0  0  0  0  0  0  0  5  0  0  0  0 -1  0  0  4  
5  0  0  0  0  0  1  0  0  0  0  0  0  0  0  4  4  4  4  1  0  0  0  4  
4  4  2  0  2  4  4  0  0  0  0  0  0  0  0  0  0  0  0  1  0  1  1  0  
0  0  2  0  2  0  0  0  0  0  0  0  0  0  0  0  0  0  0  1  0  1  0  0  
0  0  2  6  2  0  0  0  0  0  0  0  0  0  0  0  0  0  0  1  7  1  0  0  

