0  0  0  0  0  0  0  2  2  2  2  2  2  0  0  0  0  0  0  0  0  0  0  0  
0  0  0  0  0  0  0  2  7  0  0  0  2  2  2  2  2  2  0  0  0  0  0  0  
0  0  2  2  2  2  0  2  2  2  2  0  0  0  0  0  0  2  0  0  0  0  0  0  
0  0  2  0 -5  0  2  0  0  0  2  2  2  2  2  2  0  2  2  2  0  0  0  0  
0  0  2  2  2  0  2  2  2  0  0  0  0  0  0  2  0  0  0  2  2  2  2  2  
0  0  0  2  2  0  0  0  2  2  2  2  2  2  2  2  2  2  0  0 -1  0  0  2  
0  2  2  0  0  0  0  0  2  2  0  0  0 -5  2  0  0  2  0  0 -1  0  0  2  
2  2  0  0  2  0  0  0 -1  2 -1  0  0  0  2  0  2  2  0  2  2  2  2  2  
0  0  0  0  2  0  0  0 -1  2 -1  0  0  0  2  0  2  0  0  2  0  0  0  0  
0  0  0  0  2  0  0  0 -1  2 -1  0  0  0  2  2  2  0  2  2  0  0  0  0  
0  2  2  2  0  0  0  0  0 -1  0  0  0  0  0  0  0  0  2  0  0  0  0  0  
0  2  0  2  0  0  0 -1  0  0  0  0  2  2  2  2  2  2  2  0  0  0  0  0  
6  2  0  2 -5  0  0  0  0  0  0  0  2  0  0  0  0  0  0  0  0  0  0  0  
2  2  0  2  2  2  2  2  2  2  2  2  2  0  0  0  0  0  0  0  0  0  0  0  

